####################
#@...#........#...@#
#.##.#.######.#.##.#
#.##.#.######.#.##.#
#..................#
##.#.###.##.###.#.#
 #.#.....##.....#.#
 #.###.######.###.#
 #................#
 #.### ##  ## ###.#
 #.#.. #4567# ..#.#
##.#.# ###### #.#.##
#....#........#....#
##.#####.##.#####.##
 #.......##.......#
##.###.######.###.##
#..@#....##....#@..#
#.######.##.######.#
#..................#
####################