####################
#..................#
#.#.####.##.####.#.#
#@#....#.##.#....#@#
#.#.##.#.##.#.##.#.#
#....#........#....#
####.#.######.#.####
# #..............# #
###.##        ##.###
#...## ##  ## ##...#
###.## #4567# ##.###
  #... ###### ...#
 ##.##        ##.###
 #................#
 #.##.########.##.#
 #..#..........#..#
###.#........###.###
#@#.###......###.#@#
#..................#
####################
